000000000000000000000000000000000000000000000000000000000000000000000000000000000000000000000000000000000000000000000000000000000000000000000000000000
000000000000000000000000000000000000000000000000000000000000000000000000000000000000000000000000000000000000000000000000000000000000000000000000000000
000000000000000000000000000000000000000000000000000000000000000000000000000000000000000000000000000000000005550000000000000000000000000000000000000000
000000000000000000000000000000000000000000000000000000000000000000000000000000000000000000000000000000000005550000000000000000000000000000000000000000
000000000000000000000000000000000000000000000000000000000000000000000000000000000000000000055500000000000000000000000000000000000000000000000000000000
000000000000000000000000000000000000000000000000000000000000005550000000000000005550000000055500000000000000000000055500000000000000000000000000000000
0000000000000000000000000000000000000000000000000000000000000055500000000000000055500000000000XXXXXXXXXXXX00000000055500000000000000055550000000000000
0000000000000000000000000000000000055000000000000000000000000000000000000000000000000000000000XXYXYXXYXXXX00000000000000000055000000055550000000000000
000000000000000000000005500000000005500000000000000000000000000000000000000000000000XXXXXX0000XXXXXXXXXXXX0000000XXXXXXXXXXX00500000000000000000000000
0000000000000000000000055000000000000000000055500000XXXXXXXXX00000XXXXXXXXXXXXX00000XYXXXX0000XXXXZXYXYXXX0000000XYXZXXYXXXX00050000000000000000000000
00000000000000000000000000000000000000XXXXXX0005000XXXXXYXZXX00000XYXXXZXYXXXXX00000XXXXYX0000XYXXXXXXXXXX0000000XXXXXXXXXXX000XXXX0000000000000000000
00000000000000000000000000XXXXXXXX0000XYXYXX000XXXXXXYXXXXXXX00000XXXXXXXXXXXYX00000XXXXXX0000XXXXXXXYXZXX0000000XXXXXXXXYXX000XZXX0000000000000000000
0000000000XXXXXXXXXXXX0000XXXXZXYX0000XXXXXX000XXYXXXXXXXXXYX00000XXYXZXXXXXXXX00000XYXZXX0000XXXXXYXXXXXX0000000XYXYXXXXXXX000XXXX0000000XXXX00000000
XXXXXXXXXXXXXXXXXXXXXX0000XYXXXXXX0000XXYXZX000XXXXXZXYXYXXXX00000XXXXXXXYXZXXX00000XXXXXX0000XZXYXXXXXXXX0000000XXXXXXZXYXX000XXYX0000000XXXXXXXXXXXX
XXXXXXXXXXXXXXXXXXXXXX0000XYXXXXXX0000XXYXZX000XXXXXZXYXYXXXX00000XXXXXXXYXZXXX00000XXXXXX0000XZXYXXXXXXXX0000000XXXXXXZXYXX000XXYX0000000XXXXXXXXXXXX