000000000000000000000000000000000000000000000000000000000000000000000000000000000000000000000000000000000000000000000000000000000000000000000000000000
000000000000000000000000000000000000000000000000000000000000000000000000000000000000000000000000000000000000000000000000000000000000000000000000000000
000000000000000000000000000000000000000000000000000000000000000000000000000000000000000000000000000000000000000000000000000000000000000000000000000000
000000000000000000000000000000000000000000000000000000000000000000000000000000000000000000000000000000000000000000000000000000000000000000000000000000
000000000000000000000000000000000000000000000000000000000000000000000000000000000000000000000000000000000000000000000000000000000000000000000000000000
000000000000000000000000000000000000000000000000000000000000000050000000000005550000000000050000000000000000000000000000000000000000000000000000000000
000000000000000000000000000000000000000000000000000000000000000500000000000000000000000000505000000000000000000000000000000555555500000000000000000000
00000000000000000000000000000000000000000000005500000000000000500000000000000I0I000000000500050000000000000000000000000000JJJJJJJJJ0000000000000000000
000000000000000000500000000000000000000000000500000200200000000000000000000I0I0I0I000000500I0050000005555555555555555000000000500000000055555000000000
00000000000000000500000000000000005500000000500HHHHHHHHHHHHHHH0000IIIIIIIIIIIIIIIIIIIIIII00I00IIIIIII0I0I0I0I0I0I0I0I0000000050500000000JJJJJ000000000
00000000000000005000000000000000050000001000000HHHHHHHHHHHH33I0000IIIIIIIIIIIIIII33IIIIII00I00III3III0I0I0I0I0I0I0I0II00000000000000000000000000000000
00000000IIIIIIIII0000000000000005000HHHHHHHHHHHHHHHIIIIIIIIIII0000III33IIIIIIIIIIIIIIIIII00I00IIII3II0I0I0I0I0I0I0I0II00000000100000000505050500000000
0020000IIVVIIIVVII000200020000000000HHHHHHHHHHHHHHIIII44IIIIII0000IIII3IIIIIIIIIIIIIIIIII00I00IIIIIII0I0I0I0I0I0I0I0IIIHHHHHHHHHHHHHHHH0H0H0H000000000
HHHHHHII0000I0000IIHHHHHHHHHHHHHH000HHHHHHHHHHIIIIIIII4IIIIIII0000IIIIIIIIIIIIII44IIIIIII00I00I44IIII0I0I0I0I0I0I0I0II33IHHHHHHHHHHHHHH0H0H0H0HHHHHHHH
HHHHHHI00000I00000IHHHHHHHHHHHHHH000HHHHHHHHIII33IIIIIIIIIIIII0000IIIIIIIIIIIII444IIIIIII00I00III4III0I0I0I0I0I0I0I0IIIIIHHHHHHHHHHHHHH0H0H0H0HHHHHHHH
