000000000000000000000000000000000000000000000000000000000000
000000000000000000000000000000000000000000000000000000000000
000000000000000000000000000000000000000000000000000000000000
000000000000000000000000000000000000000000000000000000000000
000000000000000000000000000000000000000000000000000000000000
000000000000000000000000000000000000000000000000000000000000
000000000000000000000000000000000000000000000000000000000000
000000000000000000000000000000055000000000000000000000000000
000000000000000000000000000000500500000000000000005555500000
0000000005000000000000000000000000000000000000000FEEEEEG0000
000000005000000000000000000000000000000000000000000000000000
00000005000000000000000CBBBBBD0000CBBBBBBBBD0000000000000000
000110000000022000110CBHHHHHHM0220LHHHHHHHHM0002200011002200
BBBBBBBD00CBBBBBBBBBBHHHHHHHHHBBBBHHHHHHHHHHBBBBBBBBBBBBBBBB
HHHHHHHM00LHHHHHHHHHHHHHHHHHHHHHHHHHHHHHHHHHHHHHHHHHHHHHHHHH