000000000000000000000000000000000000000000000000000000000000
000000000000000000000000000000000000000000000000000000000000
000000000000000000000000000000000000000000000000000000000000
000000000000000000000000000000000000000000000000000000000000
000000000000000000000000000000000000000000000000000000000000
000000000000000000000000000000000000000000000000000000000000
000000000000000000000000000005000000000000000000000000000000
000000000000000000000000000050500000000000000000000000000000
000000000000000000000000000000000000000000000000555000000000
000000000500000000000000000000000000000000000000555000000000
00000000500000000000000AAAA0000000000000000000AAAAA000000000
00000005000000000000AAAAAAA000000000000000000000000000000000
00000000000000000AAAAAAAAAA000000000000AAAA00000000000000000
AAAAAAAA00AAAAAAAAAAAAAAAAAAAAAAAAAAAAAAAAAAAAAAAAAAAAAAAAAA
AAAAAAAA00AAAAAAAAAAAAAAAAAAAAAAAAAAAAAAAAAAAAAAAAAAAAAAAAAA