00000000000000000000000000000000000000000000000000000000000000000000000000000000000000000000000000000000000000000000000000000000000000000000000000000
0000000000000000000000000000000000000000000000000000000000000000000000000000000000000000000A000000000000000000000000000000000000000000000000000000000
0000000000000000000000000000000000000000000000000000000000000000000000000000000000000000000A000000000000000000000000000000000000000000000000000000000
0000000000000000000000000000000000000000000000000000000000000000000000000000000000000000000A000000000000000000000000000000000000000000000000000000000
0000000000000000000000000000000000000000000000000000000000000000000000000000000000000000000A000000000000000000000000000000000000000000000000000000000
00000000000000000000000000000000000000000000000000000000000000000000000000000000000000000000000000000000000000000000000000000000000000000000000000000
00000000000000000000000000000000000000000000000000000000000000005000000000005550000000000005000000000000000000000000000000000000000000000000000000000
00000000000000000000000000000000000555550000000000000000000000050000000000000000000000000050500000000000000000000000000000555555500000000000000000000
0000000000000000000000055550000000AAAAAAA0000000000000000000005000000000000A0A0A00000000050005000000000000000000000000000AAAAAAAAA0000000000000000000
0000000000000555000000AAAAAA000000000500000000000000000000000000000000000A0A0A0A0A000000500A005000000555555555555555500000000500000000055555000000000
000000000000AAAAA0000000550000000000505000000000000000AAAAAAAA0000AAAAAAAAAAAAAAAAAAAAAAA00A00AAAAAAAAA0A0A0A0A0A0A0A000000050500000000AAAAA000000000
0000000000000050000000000000000000050005000000000000AAAAAAAAAA0000A000000000000000000000A00A00A0000000A0A0A0A0A0A0A0A00000000000000000000000000000000
000000AAA0000000000000000000000000000000000000AAAAAAAAAAAAAAAA0000A000000000000000000000A00A00A0000000A0A0A0A0A0A0A0A00000000000000000505050500000000
AAAAAAAAAAAAAAAAAAAAAAAAAAAAAAAAAAAA000AAAAAAAAAAAAAAAAAAAAAAA0000A000000000000000000000A00A00A0000000A0A0A0A0A0A0A0AAAAAAAAAAAAAAAAAA0A0A0A0AAAAAAAA
AAAAAAAAAAAAAAAAAAAAAAAAAAAAAAAAAAAA000AAAAAAAAAAAAAAAAAAAAAAA0000A000000000000000000000A00A00A0000000A0A0A0A0A0A0A0AAAAAAAAAAAAAAAAAA0A0A0A0AAAAAAAA
