000000000000000000000000000000000000000000000000000000000000000000000000000000000000000000000000000000000000000000000000000000000000000000000000000000
0000000000000000000000000000000000000000000000000000000000000000000000000000000000000000000I0000000000000000000000000000000000000000000000000000000000
0000000000000000000000000000000000000000000000000000000000000000000000000000000000000000000I0000000000000000000000000000000000000000000000000000000000
0000000000000000000000000000000000000000000000000000000000000000000000000000000000000000000I0000000000000000000000000000000000000000000000000000000000
0000000000000000000000000000000000000000000000000000000000000000000000000000000000000000000I0000000000000000000000000000000000000000000000000000000000
000000000000000000000000000000000000000000000000000000000000000000000000000000000000000000000000000000000000000000000000000000000000000000000000000000
000000000000000000000000000000000000000000000000000000000000000050000000000055500000000000050000000000000000000000000000000000000000000000000000000000
000000000000000000000000000000000005555500000000000000000000000500000000000000000000000000505000000000000000000000000000005555555000000000000000000000
0000000000000000000000055550000000JJJJJJJ0000000000000000000005000000000000I0I0I00000000050005000000000000000000000000000JJJJJJJJJ00000000000000000000
0000000000000555000000HHHHHH000000000500000000000000000000000000000000000I0I0I0I0I000000500I0050000005555555555555555000000005000000000555550000000000
000000000000HHHHH0000000550000000000505000000000000000HHHHHHHH0000IIIIIIIIIIIIIIIIIIIIIII00I00IIIIIII0I0I0I0I0I0I0I0I000000050500000000JJJJJ0000000000
0000000000000050000000000000000000050005000000000000HHHHHHHHHH0000I000000000000000000000I00I00I0000000I0I0I0I0I0I0I0I000000000000000000000000000000000
000000HHH0000000000000000000000000000000000000HHHHHHHHHHHHHHHI0000I000000000000000000000I00I00I0000000I0I0I0I0I0I0I0I000000000000000005050505000000000
HHHHHHHHHHHHHHHHHHHHHHHHHHHHHHHHHHHH000HHHHHHHHHHHHHHHHHHHHIII0000I000000000000000000000I00I00I0000000I0I0I0I0I0I0I0IHHHHHHHHHHHHHHHHH0H0H0H0HHHHHHHHH
JJJJJJJJJJJJJJJJJJJJJJJJJJJJJJJJJJJJ000JJJJJJJJJJJJJJJJJJJJJJJ0000J000000000000000000000J00J00J0000000J0J0J0J0J0J0J0JJJJJJJJJJJJJJJJJJ0J0J0J0JJJJJJJJJ
