00000000000000000000000000000000000000000000000000000000000000000000000000000000000000000000000000000000000000000000000000000000000000000000000000000
00000000000000000000000000000000000000000000000000000000000000000000000000000000000000000000000000000000000000000000000000000000000000000000000000000
00000000000000000000000000000000000000000000000000000000000000000000000000000000000000000000000000000000000000000000000000000000000000000000000000000
0000000000000000000000000000000000000000000000000000000000000000000000000000000000000000000000000NOOOOOOOOOOOOOOOOOOOOOOOOOOOOOK000000000000000000000
0000000000000000000000000000000000000000000000000000000000000000000000000000055550000000000000000URRRRRRRRRRRRRRRRRRRRRRRRRRRRRT000000000000000000000
0000000000000000000000000000000000000000000000000000000000000000000000000000055550000000000000000SQQQQQQQQQQQQQQQQQQQQQQQQQQQQQP000000000000000000000
00000000000000000000000000000000000000000000000000000000005000005555550000000555500000000000000000000000000000000000000000000000000000000000000000000
000000000000000000000000000000000000000000000000000000000500000FEEEEEEG000000000000000000000000000000000000055500000000000555000000000000000000000000
00000000000000000000000000000000000000000000500000000000500000000000000000000000000000000000000000000000000000000000000000000000000000000000000000000
000000000000000000000000000000000000000000050000FEEEEEEEG0000000000000000000005500000000000000000000000000000B0000000000000B0000000000000000000000000
000000000000000050000000000000500000000000500000000000005000000000000000000000000000000000000005000000000200CHD00000100000CHD000000000000000005000000
0000000000000005000000000000050FEEEEEEEEEEG0000000000005000000000000000000000CBBD000000000000050CBBBBBBBBBBBHHHBBBBBBBBBBBHHHBBBD00000000000050000000
0002000020010050000200000200500000000000000000001001005000000000200001000022CHHHHD000200002005000aaa0050505050505050505050500aaa000200020000500000010
BBBBBBBBBBBBBBD000CBBBBBBBBBBBD000000000000CBBBBBBBBBBD000CBBBBBBBBBBBBBBBBBHHHHHHBBBBBBBBBBBBBH0H0H0H0H0H0H0H0H0H0H0H0H0H0H0H0HHBBBBBBBBBBBD000CBBBB
HHHHHHHHHHHHHHM000LHHHHHHHHHHHM000000000000LHHHHHHHHHHM000LHHHHHHHHHHHHHHHHHHHHHHHHHHHHHHHHHHHHH0H0H0H0H0H0H0H0H0H0H0H0H0H0H0H0HHHHHHHHHHHHHM000LHHHH