00000000000000000000000000000000000000000000000000000000000000000000000000000000000000000000000000000000000000000000000000000000000000000000000000000
00000000000000000000000000000000000000000000000000000000000000000000000000000000000000000000000000000000000000000000000000000000000000000000000000000
00000000000000000000000000000000000000000000000000000000000000000000000000000000000000000000000000000000000000000000000000000000000000000000000000000
000000000000000000000000000000000000000000000000000000000000000000000000000000000000000000000000000000000000000NOOOOOOOOOK000000000000000000000000000
00000000000000000000000000000000000000000000000000000000000000000000000000000555500000000000000000000000000000UQRRRRRRRRRQT00000000000000000000000000
0000000000000000000000000000000000000000000000000000000000000000000000000000055550000000000000000000000000000000SQQRRRQQP0000000000000000000000000000
0000000000000000000000000000000000000000000000000000000000500000555555000000055550000000000000000000000000000000000SQP0000000000000000000000000000000
000000000000000000000000000000000000000000000000000000000500000FEEEEEEG000000000000000000000000000000000000055500000000000555000000000000000000000000
00000000000000000000000000000000000000000000500000000000500000000000000000000000000000000000000000000000000000000000000000000000000000000000000000000
000000000000000000000000000000000000000000050000FEEEEEEEG0000000000000000000005500000000000000000000000000000E0000000000000E0000000000000000000000000
000000000000000050000000000000500000555000500000000000005000000000000000000000000000000000000005000555500200FEG00000100000FEG000000000000000000000000
0000000000000005000000000000050FEEEEEEEEEEG0000000000005000000000000000000000CBBD000000000000050FEEEEEEEEEEEEEEEEEEEEEEEEEEEEEEG000000000000000000000
0002000020010050000200000200500000000000000000001001005000000000200001000022CHHHHD0002000020050000000000505050505050505050505050002000200000000000100
BBBBBBBBBBBBBBD000CBBBBBBBBBBBD000000000000CBBBBBBBBBBD000CBBBBBBBBBBBBBBBBBHHHHHHBBBBBBBBBBBBBH0H0H0H0H0H0H0H0H0H0H0H0H0H0H0H0HHBBBBBBBBBBBD000CBBBB
HHHHHHHHHHHHHHM000LHHHHHHHHHHHM000000000000LHHHHHHHHHHM000LHHHHHHHHHHHHHHHHHHHHHHHHHHHHHHHHHHHHH0H0H0H0H0H0H0H0H0H0H0H0H0H0H0H0HHHHHHHHHHHHHM000LHHHH