000000000000000000000000000000000000000000000000000000000000000000000000000000000000000000000000000000000000000000000000000000000000000000000000000000
000000000000000000000000000000000000000000000000000000000000000000000000000000000000000000000000000000000000000000000000000000000000000000000000000000
000000000000000000000000000000000000000000000000000000000000000000000000000000000000000000000000000000000000000000000000000000000000000000000000000000
000000000000000000000000000000000000000000000000000000000000000000000000000000000000000000000000000000000000000000000555000000000000000000000000000000
000000000000000000000000000000000000000000000000000000000000000000000000000000000000000000000000000000000000000000000555000000000000000000000000000000
000000000000000000000000000000000000000000000000000000000000000000000000000000005550000000000000000000000005000000000000000000000000000000000000000000
000000000000000000000000000000000000000000000000000000000000000000000000000000005550000000000000000000000050AAAAAA000000000000005500000000000000000000
000000000000000000000000000000000000000000000555500000000000000055000000000000000000000000005500000000050000AAAAAA000000000000000000000000000000000000
000000000000000000000000000000000000000550000555500000000000000555500000000AAA00000000000000550000000050AAAA000000000000000000000000000000000000000000
00000000000055550000000000000000550000055000000000000000000000000000000000AAAA00000000000000000000000000AAAA00000000000AAAAAAAAA00AAA00000000000000000
000000000000555500000000000000005500000000AAA0000AAA0000000AAAA0000AAAAAAAAAAAAAAAAAAAAAAAA0000AAAAAAAAA00000000000000000000000000000AAA00000000000000
00000000000000000000000000000000000AAA000005000000500000AAAAAAA0000AAAAA000000000000000000A0000A0000000000000000000000000000000000000000AAA00000000000
0000000000AAAAAAAA00000AAAAAAAA00000000000000000000000AAAAAAAAA0000AAAAA000000000000000000A0000A0000000000000000000000000000000000000000000AAA00000000
AAAAAAAAAAAAAAAAAAAAAAAAAAAAAAAAAAAAAAAAAAAAAAAAAAAAAAAAAAAAAAA0000AAAAA000000000000000000A0000A0000000000000000000000000000000000000000000000AAAAAAAA