000000000000000000000000000000000000000000000000000000000000
000000000000000000000000000000000000000000000000000000000000
000000000000000000000000000000000000000000000000000000000000
000000000000000000000000000000000000000000000000000000000000
000000000000000000000000000000000000000000000000000000000000
000000000000000000000000000000000000000000000000000000000000
000000000000000555000000000000000000000000000000000000000000
000000000000AAAAAAAA0000000000000000000000000000000000000000
000000000000000000000000000000000000000000000000000000000000
000000000A00000000000000000000000000000000000000000000000000
00000000AA0000000000000000000000000000AAAAA00000000000000000
0000000AAA00000000000000000000000000000000000000000AAA000000
000000AAAA00000000000000000000005555555555500000000000000000
AAAAAAAAAA00AAAAAAAAAAAAA00AAAAAAAAAAAAAAAAAAAAAAAAAAAAAAAAA
AAAAAAAAAA00AAAAAAAAAAAAA00AAAAAAAAAAAAAAAAAAAAAAAAAAAAAAAAA