000000000000000000000000000000000000000000000000000000000000000000000000000000000000000000000000000000000000000000000000000000000000000000000000000000
0000000000000000000000000000000000000000000000000000000000000000000000000000000000000000000A0000000000000000000000000000000000000000000000000000000000
0000000000000000000000000000000000000000000000000000000000000000000000000000000000000000000A0000000000000000000000000000000000000000000000000000000000
0000000000000000000000000000000000000000000000000000000000000000000000000000000000000000000A0000000000000000000000000000000000000000000000000000000000
0000000000000000000000000000000000000000000000000000000000000000000000000000000000000000000A0000000000000000000000000000000000000000000000000000000000
000000000000000000000000000000000000000000000000000000000000000000000000000000000000000000000000000000000000000000000000000000000000000000000000000000
000000000000000000000000000000000000000000000000000000000000000050000000000055500000000000050000000000000000000000000000000000000000000000000000000000
000000000000000000000000000000000005555500000000000000000000000500000000000000000000000000505000000000000000000000000000005555555000000000000000000000
0000000000000000000000055550000000AAAAAAA0000000000000000000005000000000000A0A0A00000000050005000000000000000000000000000AAAAAAAAA00000000000000000000
0000000000000555000000AAAAAA000000000500000000000000000000000000000000000A0A0A0A0A000000500A0050000005555555555555555000000005000000000555550000000000
000000000000AAAAA0000000550000000000505000000000000000AAAAAAAA0000AAAAAAAAAAAAAAAAAAAAAAA00A00AAAAAAAAA0A0A0A0A0A0A0A000000050500000000AAAAA0000000000
0000000000000050000000000000000000050005000000000000AAAAAAAAAA0000A000000000000000000000A00A00A0000000A0A0A0A0A0A0A0A000000000000000000000000000000000
000000AAA0000000000000000000000000000000000000AAAAAAAAAAAAAAAA0000A000000000000000000000A00A00A0000000A0A0A0A0A0A0A0A000000000000000005050505000000000
AAAAAAAAAAAAAAAAAAAAAAAAAAAAAAAAAAAA000AAAAAAAAAAAAAAAAAAAAAAA0000A000000000000000000000A00A00A0000000A0A0A0A0A0A0A0AAAAAAAAAAAAAAAAAA0A0A0A0AAAAAAAAA
AAAAAAAAAAAAAAAAAAAAAAAAAAAAAAAAAAAA000AAAAAAAAAAAAAAAAAAAAAAA0000A000000000000000000000A00A00A0000000A0A0A0A0A0A0A0AAAAAAAAAAAAAAAAAA0A0A0A0AAAAAAAAA
