00000000000000000000000000000000000000000000000000000000000
00000000000000000000000000000000000000000000000000000000000
00000000000000000000000000000000000000000000000000000000000
00000000000000000000000000000000000000000000000000000000000
00000000000000000000000000000000000000000000000000000000000
00000000000000000000000000000000000000000000000000000000000
00000000000000000000000000000500000000000000000000000000000
00000000000000000000000000005050000000000000000000000000000
00000000000000000000000000000000000000000000000055500000000
00000000050000000000000000000000000000000000000055500000000
00000000500000000000000AAAA0000000000000000000AAAAA00000000
00000005000000000000AAAAAAA00000000000000000000000000000000
00000000000000000AAAAAAAAAA000000000000AAAA0000000000000000
AAAAAAAA00AAAAAAAAAAAAAAAAAAAAAAAAAAAAAAAAAAAAAAAAAAAAAAAAA
AAAAAAAA00AAAAAAAAAAAAAAAAAAAAAAAAAAAAAAAAAAAAAAAAAAAAAAAAA