000000000000000000000000000000000000000000000000000000000000
000000000000000000000000000000000000000000000000000000000000
000000000000000000000000000000000000000000000000000000000000
000000000000000000000000000000000000000000000000000000000000
000000000000000000000000000000000000000000000000000000000000
000000000000000000000000000000000000000000000000000000000000
000000000000000000000000000005000000000000000000000000000000
000000000000000000000000000050500000000000000000000000000000
000000000000000000000000000000000000000000000000055500000000
000000000500000000000000000000000000000000000000055500000000
00000000500000000000000CBBD000000000000000000000FEEEG0000000
00000005000000000000CBBKKKM000000000000000000000000000000000
00000000000000000CBBKKKKKKM000000000000CBBD00000000000000000
BBBBBBBD00CBBBBBBKKKKKKKKKKBBBBBBBBBBBBKKKKBBBBBBBBBBBBBBBBB
KKKKKKKM00LKKKKKKKKKKKKKKKKKKKKKKKKKKKKKKKKKKKKKKKKKKKKKKKKK