000000000000000000000000000000000000000000000000000000000000000000000000000000000000000000000000000000000000000000000000000000000000000000000000000000
000000000000000000000000000000000000000000000000000000000000000000000000000000000000000000000000000000000000000000000000000000000000000000000000000000
000000000000000000000000000000000000000000000000000000000000000000000000000000000000000000000000000000000000000000055555550000000000000000000000000000
000000000000000000000000000000000000000000000000000000000000000000000000000000000000000000000000000000000000000000055555550000000000000000000000000000
000000000000000000000000000000000000000000000000000000000000000000000000000000000000000000000000000000000000000000000000000000000000000000000000000000
00000000000000000000000000000000000050000000000000000000000000000000000000000000000000000000000000555555500000000FEEEEEEEEEG00000000000000000000000000
000000000000000000000000000000000005000000000000000000000000000000000000000000000000055555000000FEEEEEEEEEG0000000000000000000000000000000000000000000
00000000000000000000000000000000555000000000000000000050000000000000000000000000000FEEEEEEEG0000000000000000000000000000000000000000055550000000000000
00000000000000000000000000000FEEEEG000000000000000000FEG0000055550000000055555000000000000000000000000000000000000000000000000000000FEEEEG000000000000
00000000000000000000000000000000000000000000555000000000000FEEEEEEG0000FEEEEEEEG0000000000000000000000500000000000000055555000000000000000000000000000
000000000CBBD000000FEEEEEG0000000000000CBBBBBBBBBD00000000000055000000000000000005000000000000000000050000000000000FEEEEEEEEEG000000000000000000000000
00000000CHHHHD0000000555000000000000000LHHHHHHHHHHD000000000050050000000000000005000000000000000000000000000000000000000000000000000000000000B00000000
0000000CHHHHHHD0000000000000000CBBBBBBBHHHHHHHHHHHHD0000000000000000000000000000000000000000CBBBBBBBD000000000000000505050505000000000000000CHD0000000
CBBBBBBHHHHHHHHBBBBBBBBBBBBBBBBHHHHHHHHHHHHHHHHHHHHHBBBBBBBBBD00CBBBBBBBBBBBBBBBD00CBBBBBBBBHHHHHHHHM000CBBBBBBBBBBD0B0B0B0B0CBBBBBBBBBBBBBBHHHBBBBBBB
LHHHHHHHHHHHHHHHHHHHHHHHHHHHHHHHHHHHHHHHHHHHHHHHHHHHHHHHHHHHHM00LHHHHHHHHHHHHHHHM00LHHHHHHHHHHHHHHHHM000LHHHHHHHHHHM0H0H0H0H0LHHHHHHHHHHHHHHHHHHHHHHHH