00000000000000000000000000000000000000000000000000000000000000000000000000000000000000000000000000000000000000000000000000000000000000000000000000000
00000000000000000000000000000000000000000000000000000000000000000000000000000000000000000000000000000000000000000000000000000000000000000000000000000
00000000000000000000000000000000000000000000000000000000000000000000000000000000000000000000000000000000000000000000000000000000000000000000000000000
00000000000000000000000000000000000000000000000000000000000000000000000000000000000000000000000000000000000000000000000000000000000000000000000000000
00000000000000000000000000000000000000000000000000000000000000000000000000000000000000000000000000000000000000000000000000000000000000000000000000000
00000000000000000000000000000000000000000000000000000000000000000000000000000000000000000000000000000000000000000000000000000000000000000000000000000
000000000000000000000000000000000000000000000000000000000000000000000000000000000005500000000000AAA000000AAA00000000000000000000000000000000000000000
000000000000000000000000000000000000000000000000000000000000000000000000000000000AAAAAA00000000000000000000000000000000000000000000500000000000000000
0000000000000000000000000000000000000000000055000000000000000000000000005500000000000000000000000000000000000000000000000000000000AAAA000000000000000
000000000000000000000000000000050000AAA000AAAAAA000000000000000000000AAAAAAA0000000000000000055500000000000000000000000000000550000000000005500000000
00000000000000000000000500000AAAA00000000AAAAAAAA000000000000000000000000000000000000000000AAAAAAAA000000000000000000050000AAAAA000000000000055000000
0000000000AA000000000AAAAA00000000000000AAAAAAAAAA00000005000000A0000000000000000000000500000000000000000000000000000AAA000000000000AAA00000000000000
000000000AAA000000000000000000000000000AAAAAAAAAAAA0005000005000AA00000A00000A00000000000000000000000000000000005550000000000000000000000000000A00000
AAAAAAAAAAAAAAAAAAAAAAAAAAAAAAAAAA00AAAAAAAAAAAAAAAAAAAAAAAAAAAAAAAAAAAAAAAAAAAAAAAAA00000AAAAAAAAAAA00000AAAAAAAAAAAAAAA000AAAAAAAAAAAAAAAAAAAAAAAAA