000000000000000
000000000000000
000000000000000
000000000000000
000000000000000
000000000000000
000000000000000
000000000000AAA
000000000000000
000000000A00000
00000000AA00000
0000000AAA00000
000000AAAA00000
AAAAAAAAAA00AAA