000000000000000000000000000000000000000000000000000000000000000000000000000000000000000000000000000000000000000000000000000000000000000000000000000000
000000000000000000000000000000000000000000000000000000000000000000000000000000000000000000000000000000000000000000000000000000000000000000000000000000
000000000000000000000000000000000000000000000000000000000000000000000000000000000000000000000000005555555555000000000000000000000000000000000000000000
000000000000000000000000000000000000000000000000000000000000000000000000000000000000000000000000005555555555000000000000000000000000000000000000000000
000000000000000000000000000000000000000000000000000000000000000000000000000000005500000000000000005555555555000000000000000000000000000000000000000000
000000000000000000000000000000000000000000000000550000000000000550000000000000055550000005500000AAAAAAAAAAAAAA0000000000000000000000000000000000000000
00000000000000000000000000000000000000000000000055000000000000055000000055000000000000000000AAAAAAAAAAAAAAAAAAAAAA000000055550000000000000000000000000
000000000000AAAAAA000000000000000000000000000000000000AAAA0000000000000055000AAAAAAAA000000000AAAAAAAAAAAAAAAAAA00000000AAAAAA000555500000000000000000
000000000AAAAAAAAAAAA0000000000000550000AAAAA000000AAAAAAAAAA00000000000000AAAAAAAAAAAA00000000000000000000000000000000000AA0000AAAAAA0000555500000000
0000000000000000000000000000000000550AAAAAAAAAAA0000000AA0000000000AAAA00000000055000000000000000055500005550000000000000055000000AA00000AAAAAA0000000
00000000005550000555000000000000000000000000000000000005500000000AAAAAAAA000000055000000000000000055500005550000000000000055000000AA000000055000000000
0000000000555000055500000000AAAAAAA000000000550000000005500000000005555000000000AA0000000000000000000000000000000000000000AA00000055000000055000000000
0000000000000000000000000AAAAAAAAAAAAA00000000000000000AA0000000000000000000000AAAA000000000000AAAAAAAAAAAAAAAA00000000000AA000000550000000AA000000000
AAAAAAAAAAAAAAAAAAAAAAAAAAAAAAAAAAAAAAAAAAAAAAAAAAAAAAAAAAAAAAAAAAAAAAAAAAAAAAAAAAAAAAAAAAAAAAAAAAAAAAAAAAAAAAAAAAAAAAAAAAAAAAAAAAAAAAAAAAAAAAAAAAAAAA

