000000000000000000000000000000000000000000000000000000000000000000000000000000000000000000000000000000000000000000000000000000000000000000000000000000
000000000000000000000000000000000000000000000000000000000000000000000000000000000000000000000000000000000000000000000000000000000000000000000000000000
000000000000000000000000000000000000000000000000000000000000000000000000000000000000000000000000000000000000000000000000000000000000000000000000000000
000000000000000000000000000000000000000000000000000000000000000000000000000000000000000000000000000000000000000000000000000000000000000000000000000000
000000000000000000000000000000000000000000000000000000000000000000000000000000000000000000000000000000000000000000000000000000000000000000000000000000
000000000000000000000000000000000000000000000000000000000000000000000000000000000000000000000000000000000000000000000000000000000000000000000000000000
000000000000000000000000000000000000000000000000000000000000000000000000000000000005500000000000AAA000000AAA000000000000000000000000000000000000000000
000000000000000000000000000000000000000000000000000000000000000000000000000000000AAAAAA000000000000000000000000000000000000000000005000000000000000000
0000000000000000000000000000000000000000000055000000000000000000000000005500000000000000000000000000000000000000000000000000000000AAAA0000000000000000
000000000000000000000000000000050000AAA000AAAAAA000000000000000000000AAAAAAA00000000000000000555000000000000000000000000000005500000000000055000000000
00000000000000000000000500000AAAA00000000AAAAAAAA000000000000000000000000000000000000000000AAAAAAAA000000000000000000050000AAAAA0000000000000550000000
0000000000AA000000000AAAAA00000000000000AAAAAAAAAA00000005000000A0000000000000000000000500000000000000000000000000000AAA000000000000AAA000000000000000
000000000AAA000000000000000000000000000AAAAAAAAAAAA0005000005000AA00000A00000A00000000000000000000000000000000005550000000000000000000000000000A000000
AAAAAAAAAAAAAAAAAAAAAAAAAAAAAAAAAA00AAAAAAAAAAAAAAAAAAAAAAAAAAAAAAAAAAAAAAAAAAAAAAAAA00000AAAAAAAAAAA00000AAAAAAAAAAAAAAA000AAAAAAAAAAAAAAAAAAAAAAAAAA
AAAAAAAAAAAAAAAAAAAAAAAAAAAAAAAAAA00AAAAAAAAAAAAAAAAAAAAAAAAAAAAAAAAAAAAAAAAAAAAAAAAA00000AAAAAAAAAAA00000AAAAAAAAAAAAAAA000AAAAAAAAAAAAAAAAAAAAAAAAAA