000000000000000000000000000000000000000000000000000000000000000000000000000000000000000000000000000000000000000000000000000000000000000000000000000000
000000000000000000000000000000000000000000000000000000000000000000000000000000000000000000000000000000000000000000000000000000000000000000000000000000
000000000000000000000000000000000000000000000000000000000000000000000000000000000000000000000000000000000000000000000000000000000000000000000000000000
000000000000000000000000000000000000000000000000000000000000000000000000000000000000000000000000000550000000000000000000000000000000000000000000000000
000000000000000000000000000000000000000000000000000000000000000000000000000000000000000000000000000550000005500000000000000000000000000000000000000000
000000000000000000000000000000000000000000000000000000000000000000000000000000005550000000055000000000000005500000055500000000000000000000000000000000
0000000000000000000000000000000000000000000000000000000000000000000000550000000055500000000550AAA00000000000000000055500000000000000000000000000000000
0000000000000000000000000000000000000000000000555000000000000550000000550000000000000000000000AAA00000AAAA00000000000000000055000000055550000000000000
0000000000000000000000000000000000055000000000555000000000000550000000000AAAAAA00000AAAAAA0000AAA00000AAAA0000AAAA00000AAAAA00500000055550000000000000
00000000000000000000000550000000000550000000000000000000AAAA0000000000000AAAAAA00000AAAAAA0000AAA00000AAAA0000AAAA00000AAAAA00050000000000000000000000
00000000000000000000000550000000000000AAAAAA0000000000AAAAAA0000AAAAA0000AAAAAA00000AAAAAA0000AAA00000AAAA0000AAAA00000AAAAA000AAAA0000000000000000000
00000000000000000000000000AAAAAAAA0000AAAAAA000000AAAAAAAAAA0000AAAAA0000AAAAAA00000AAAAAA0000AAA00000AAAA0000AAAA00000AAAAA000AAAA0000000000000000000
000000000000000AAAAAAA0000AAAAAAAA0000AAAAAA000000AAAAAAAAAA0000AAAAA0000AAAAAA00000AAAAAA0000AAA00000AAAA0000AAAA00000AAAAA000AAAA0000000AAAA00000000
AAAAAAAAAAAAAAAAAAAAAA0000AAAAAAAA0000AAAAAA000000AAAAAAAAAA0000AAAAA0000AAAAAA00000AAAAAA0000AAA00000AAAA0000AAAA00000AAAAA000AAAA0000000AAAAAAAAAAAA
AAAAAAAAAAAAAAAAAAAAAA0000AAAAAAAA0000AAAAAA000000AAAAAAAAAA0000AAAAA0000AAAAAA00000AAAAAA0000AAA00000AAAA0000AAAA00000AAAAA000AAAA0000000AAAAAAAAAAAA