000000000000000000000000000000000000000000000000000000000000000000000000000000000000000000000000000000000000000000000000000000000000000000000000000000
000000000000000000000000000000000000000000000000000000000000000000000000000000000000000000000000000000000000000000000000000000000000000000000000000000
000000000000000000000000000000000000000000000000000000000000000000000000000000000000000000000000000000000000000000000000000000000000000000000000000000
000000000000000000000000000000000000000000000000000000000000000000000000000000000000000000000000000000000000000000000000000000000000000000000000000000
000000000000000000000000000000000000000000000000000000000000000000000000000000000000000000000000000000000000000000000000000000000000000000000000000000
000000000000000000000000000000000000000000000000000000000000000000000000000000000000000000000000000000000000000000000000000000000000000000000000000000
000000000000000000000000000000000000000000000000000000000000000050000000000055500000000000050000000000000000000000000000000000000000000000000000000000
000000000000000000000000000000000005555500000000000000000000000500000000000000000000000000505000000000000000000000000000000555555500000000000000000000
0000000000000000000000055550000000JJJJJJJ0000000000000000000005000000000000I0I0I000000000500050000000000000000000000000000JJJJJJJJJ0000000000000000000
0000000000000555000000JJJJJJ000000000500000000000000000000000000000000000I0I0I0I0I000000500I0050000005555555555555555000000000500000000055555000000000
000000000000JJJJJ0000000550000000000505000000000000000HHHHHHHH0000IIIIIIIIIIIIIIIIIIIIIII00I00IIIIIII0I0I0I0I0I0I0I0I0000000050500000000JJJJJ000000000
0000000000000050000000000000000000050005000000000000HHHHHHHHHH0000I000000000000000000000I00I00I0000000I0I0I0I0I0I0I0II00000000I00000000000000000000000
000000HHH0000000000000000000000000000000000000HHHHHHHHHHHHHHHI0000I000000000000000000000I00I00I0000000I0I0I0I0I0I0I0II0000000III0000000505050500000000
HHHHHHHHHHHHHHHHHHHHHHHHHHHHHHHHHHHH000HHHHHHHHHHHHHHHHHHHHIII0000I000000000000000000000I00I00I0000000I0I0I0I0I0I0I0IIIHHHHHHHHHHHHHHHH0H0H0H0HHHHHHHH
HHHHHHHHHHHHHHHHHHHHHHHHHHHHHHHHHHHH000HHHHHHHHHHHHHHHHHHHIIII0000I000000000000000000000I00I00I0000000I0I0I0I0I0I0I0IIIIIHHHHHHHHHHHHHH0H0H0H0HHHHHHHH
