000000000000000000000000000000000000000000000000000000000000000000000
000000000000000000000000000000000000000000000000000000000000000000000
000000000000000000000000000000000000000000000000000000000000000000000
000000000000000000000000000000000000000000000000000000000000000000000
000000000000000000000000000000000000000000000000000000000000000000000
000000000000000000000000000000000000000000000000000000000000000000000
000000000000000000000000000000000000000000000000000000000000000000000
000000000000AAAAAAAA0000000000000000000000000000000000000000000000000
000000000000000000000000000000000000000000000000000000000000000000000
000000000A000000000000000000000000000000000000000A0000000000000000000
00000000AA00000000000000000000000000000000000000A00000000000000000000
0000000AAA0000000000000000000000000000000000000A000000000000000000000
000000AAAA000000000000000000000000000000000000A0000000000000000000000
AAAAAAAAAA00AAAAAAAAAAAAA00AAAAAAAAAAAAAAAAAAAAAAAAAAAAAAAAAAAAAAAAAA