00000000000000000000000000000
00000000000000000000000000000
00000000000000000000000000000
00000000000000000000000000000
00000000000000000000000000000
00000000000000000000000000000
00000000000000000000000000000
000000000000AAAAAAAA000000000
00000000000000000000000000000
000000000A0000000000000000000
00000000AA0000000000000000000
0000000AAA0000000000000000000
000000AAAA0000000000000000000
AAAAAAAAAA00AAAAAAAAAAAAA00AA