000000000000000000000000000000000000000000000000000000000000000000000
000000000000000000000000000000000000000000000000000000000000000000000
000000000000000000000000000000000000000000000000000000000000000000000
000000000000000000000000000000000000000000000000000000000000000000000
000000000000000000000000000000000000000000000000000000000000000000000
000000000000000000000000000000000000000000000000000000000000000000000
000000000000000000000000000000000000000000000000000000000000000000000
000000000000AAAAAAAA0000000000000000000000000000000000000000000000000
000000000000000000000000000000000000000000000000000000000000000000000
000000000A00000000000000000000000000000000000000000000000000000000000
00000000AA00000000000000000000000000000000000000000000000000000000000
0000000AAA00000000000000000000000000000000000000000000000000000000000
000000AAAA00000000000000000000000000000AAA000000000000000000000000000
AAAAAAAAAA00AAAAAAAAAAAAA00AAAAAAAAAAAAAAAAAAAAAAAAAAAAAAAAAAAAAAAAAA